{
  "walls": 10,
  "grid": [
    "~~~~....~~~~.~~~~~~",
    "~~~~...~~~~..~~~~~~",
    "..~.~...~~~..~..~~~",
    "~.........~......~~",
    "~............~~....",
    "....~~~.~..~~~~....",
    "~..~~~~....~~......",
    "....~~~..H......~..",
    "....~~~....~~.....~",
    ".~~........~~~~...~",
    ".~~...~~...~~~~...~",
    "....~~~...........~",
    "~..~~~...~~......~~",
    "..~~....~~~......~~",
    ".~~~...~~~~...~..~~"
  ]
}
